SO img/sud.xpm
NO img/nord.xpm
EA     img/est.xpm
WE img/ouest.xpm

C 135, 206,235
F 152,119,1
1111111111111111111111111 111
1000000000110000000000001 100
11111000001110000000000001 11
   100100000000000000000001
1111111110110000011100000001111111110
 10000000001100001110111111111111
111110111111111011100000010001
111111101110000011000001110111
1111011111111101111010010001
10000000000000000000000000110
1000000000000000101110010001
1100000111010101111100000N01111
11110111 1110101 1011100000101
11111111 1111111 111111111111
