SO img/sud.xpm
NO img/nord.xpm
EA            img/est.xpm
WE img/ouest.xpm

C 28,15,10
F 0,0,  26
1111111111111111111111111 111
1000000000110000000000001 100
11111000001110000000000001 11
   100100000000000000000001
1111111110110000011100000001111111110
 10000000001100001110111111111111
111110111111111011100000010001
111010101110000011000000110011
1111011111111101111010010111
10000000000000000000000000100
100000N0000000001010100000110
1101010111010101111101111111111
11101011 1110101 101110010101
11111111 1111111 11111111111